"filename", "language", "C++", "C", "comment", "blank", "total"
"d:\21\Maze3d\src\engine\baseTypes\color.cpp", "C++", 34, 0, 0, 7, 41
"d:\21\Maze3d\src\engine\baseTypes\color.hpp", "C++", 10, 0, 0, 7, 17
"d:\21\Maze3d\src\engine\baseTypes\containers\Image.cpp", "C++", 41, 0, 0, 12, 53
"d:\21\Maze3d\src\engine\baseTypes\containers\Image.hpp", "C++", 24, 0, 0, 10, 34
"d:\21\Maze3d\src\engine\baseTypes\containers\mesh.cpp", "C++", 17, 0, 0, 4, 21
"d:\21\Maze3d\src\engine\baseTypes\containers\mesh.hpp", "C++", 31, 0, 0, 6, 37
"d:\21\Maze3d\src\engine\baseTypes\gui\basicTextRender.cpp", "C++", 119, 0, 0, 23, 142
"d:\21\Maze3d\src\engine\baseTypes\gui\basicTextRender.hpp", "C++", 22, 0, 0, 4, 26
"d:\21\Maze3d\src\engine\baseTypes\gui\basicTexturedRect.hpp", "C++", 18, 0, 0, 2, 20
"d:\21\Maze3d\src\engine\baseTypes\gui\button.cpp", "C++", 52, 0, 0, 7, 59
"d:\21\Maze3d\src\engine\baseTypes\gui\button.hpp", "C++", 20, 0, 0, 4, 24
"d:\21\Maze3d\src\engine\baseTypes\gui\fullscreenBox.cpp", "C++", 22, 0, 0, 6, 28
"d:\21\Maze3d\src\engine\baseTypes\gui\fullscreenBox.hpp", "C++", 11, 0, 0, 4, 15
"d:\21\Maze3d\src\engine\baseTypes\gui\gui.hpp", "C++", 9, 0, 0, 1, 10
"d:\21\Maze3d\src\engine\baseTypes\gui\guiObject.cpp", "C++", 66, 0, 0, 14, 80
"d:\21\Maze3d\src\engine\baseTypes\gui\guiObject.hpp", "C++", 30, 0, 1, 5, 36
"d:\21\Maze3d\src\engine\baseTypes\gui\guiShaderType.hpp", "C++", 4, 0, 0, 1, 5
"d:\21\Maze3d\src\engine\baseTypes\gui\guiWindow.cpp", "C++", 26, 0, 0, 7, 33
"d:\21\Maze3d\src\engine\baseTypes\gui\guiWindow.hpp", "C++", 13, 0, 0, 3, 16
"d:\21\Maze3d\src\engine\baseTypes\gui\justRect.cpp", "C++", 36, 0, 0, 11, 47
"d:\21\Maze3d\src\engine\baseTypes\gui\justRect.hpp", "C++", 3, 0, 0, 1, 4
"d:\21\Maze3d\src\engine\baseTypes\gui\label.cpp", "C++", 43, 0, 0, 9, 52
"d:\21\Maze3d\src\engine\baseTypes\gui\label.hpp", "C++", 23, 0, 0, 2, 25
"d:\21\Maze3d\src\engine\baseTypes\gui\loadingBar.cpp", "C++", 26, 0, 0, 6, 32
"d:\21\Maze3d\src\engine\baseTypes\gui\loadingBar.hpp", "C++", 15, 0, 0, 2, 17
"d:\21\Maze3d\src\engine\baseTypes\gui\textAlign.hpp", "C++", 4, 0, 0, 1, 5
"d:\21\Maze3d\src\engine\baseTypes\oglWrappers\oglw.h", "C++", 2, 0, 0, 1, 3
"d:\21\Maze3d\src\engine\baseTypes\oglWrappers\shader.cpp", "C++", 91, 0, 0, 25, 116
"d:\21\Maze3d\src\engine\baseTypes\oglWrappers\shader.hpp", "C++", 30, 0, 0, 10, 40
"d:\21\Maze3d\src\engine\baseTypes\resource\resource.cpp", "C++", 50, 0, 0, 9, 59
"d:\21\Maze3d\src\engine\baseTypes\resource\resource.hpp", "C++", 46, 0, 0, 9, 55
"d:\21\Maze3d\src\engine\baseTypes\resource\resourceManager.cpp", "C++", 21, 0, 2, 6, 29
"d:\21\Maze3d\src\engine\baseTypes\resource\resourceManager.hpp", "C++", 49, 0, 2, 15, 66
"d:\21\Maze3d\src\engine\baseTypes\resources\external\Image.cpp", "C++", 44, 0, 0, 13, 57
"d:\21\Maze3d\src\engine\baseTypes\resources\external\Image.hpp", "C++", 23, 0, 0, 8, 31
"d:\21\Maze3d\src\engine\baseTypes\resources\external\TextFile.cpp", "C++", 29, 0, 0, 10, 39
"d:\21\Maze3d\src\engine\baseTypes\resources\external\TextFile.hpp", "C++", 17, 0, 0, 9, 26
"d:\21\Maze3d\src\engine\baseTypes\resources\external\model.cpp", "C++", 119, 0, 4, 30, 153
"d:\21\Maze3d\src\engine\baseTypes\resources\external\model.hpp", "C++", 29, 0, 0, 9, 38
"d:\21\Maze3d\src\engine\baseTypes\resources\internal\OGL\cubemapModel.cpp", "C++", 88, 0, 0, 17, 105
"d:\21\Maze3d\src\engine\baseTypes\resources\internal\OGL\cubemapModel.hpp", "C++", 21, 0, 0, 6, 27
"d:\21\Maze3d\src\engine\baseTypes\resources\internal\OGL\cubemapTexture.cpp", "C++", 69, 0, 0, 12, 81
"d:\21\Maze3d\src\engine\baseTypes\resources\internal\OGL\cubemapTexture.hpp", "C++", 22, 0, 0, 7, 29
"d:\21\Maze3d\src\engine\baseTypes\resources\internal\OGL\glresources.hpp", "C++", 8, 0, 0, 1, 9
"d:\21\Maze3d\src\engine\baseTypes\resources\internal\OGL\mesh.cpp", "C++", 87, 0, 0, 25, 112
"d:\21\Maze3d\src\engine\baseTypes\resources\internal\OGL\mesh.hpp", "C++", 26, 0, 0, 7, 33
"d:\21\Maze3d\src\engine\baseTypes\resources\internal\OGL\model.cpp", "C++", 50, 0, 2, 11, 63
"d:\21\Maze3d\src\engine\baseTypes\resources\internal\OGL\model.hpp", "C++", 20, 0, 0, 7, 27
"d:\21\Maze3d\src\engine\baseTypes\resources\internal\OGL\shader.cpp", "C++", 52, 0, 0, 15, 67
"d:\21\Maze3d\src\engine\baseTypes\resources\internal\OGL\shader.hpp", "C++", 32, 0, 0, 10, 42
"d:\21\Maze3d\src\engine\baseTypes\resources\internal\OGL\texture.cpp", "C++", 82, 0, 0, 28, 110
"d:\21\Maze3d\src\engine\baseTypes\resources\internal\OGL\texture.hpp", "C++", 50, 0, 0, 17, 67
"d:\21\Maze3d\src\engine\baseTypes\resources\internal\OGL\texturePack.cpp", "C++", 45, 0, 0, 7, 52
"d:\21\Maze3d\src\engine\baseTypes\resources\internal\OGL\texturePack.hpp", "C++", 21, 0, 0, 7, 28
"d:\21\Maze3d\src\engine\baseTypes\scene.cpp", "C++", 11, 0, 0, 4, 15
"d:\21\Maze3d\src\engine\baseTypes\scene.hpp", "C++", 23, 0, 0, 4, 27
"d:\21\Maze3d\src\engine\baseTypes\script.hpp", "C++", 12, 0, 0, 1, 13
"d:\21\Maze3d\src\engine\render\camera.cpp", "C++", 61, 0, 0, 13, 74
"d:\21\Maze3d\src\engine\render\camera.hpp", "C++", 27, 0, 0, 8, 35
"d:\21\Maze3d\src\engine\render\drawable.cpp", "C++", 55, 0, 0, 10, 65
"d:\21\Maze3d\src\engine\render\drawable.hpp", "C++", 27, 0, 0, 6, 33
"d:\21\Maze3d\src\engine\render\drawableHolder.cpp", "C++", 18, 0, 0, 5, 23
"d:\21\Maze3d\src\engine\render\drawableHolder.hpp", "C++", 12, 0, 0, 2, 14
"d:\21\Maze3d\src\engine\render\easyLineRender.cpp", "C++", 17, 0, 0, 4, 21
"d:\21\Maze3d\src\engine\render\easyLineRender.hpp", "C++", 4, 0, 0, 2, 6
"d:\21\Maze3d\src\engine\utilities\debug.hpp", "C++", 24, 0, 0, 6, 30
"d:\21\Maze3d\src\engine\utilities\fileLoader.cpp", "C++", 40, 0, 5, 8, 53
"d:\21\Maze3d\src\engine\utilities\fileLoader.hpp", "C++", 7, 0, 0, 2, 9
"d:\21\Maze3d\src\game\game_scene_enum.hpp", "C++", 4, 0, 0, 1, 5
"d:\21\Maze3d\src\game\gameprocess.cpp", "C++", 114, 0, 0, 16, 130
"d:\21\Maze3d\src\game\gameprocess.hpp", "C++", 29, 0, 0, 6, 35
"d:\21\Maze3d\src\game\maze_things\doomsDay\laserModel.cpp", "C++", 58, 0, 5, 17, 80
"d:\21\Maze3d\src\game\maze_things\doomsDay\laserModel.hpp", "C++", 14, 0, 0, 4, 18
"d:\21\Maze3d\src\game\maze_things\doomsDay\laserObj.hpp", "C++", 9, 0, 0, 2, 11
"d:\21\Maze3d\src\game\maze_things\floor\floorModel.cpp", "C++", 60, 0, 0, 17, 77
"d:\21\Maze3d\src\game\maze_things\floor\floorModel.hpp", "C++", 15, 0, 0, 4, 19
"d:\21\Maze3d\src\game\maze_things\legacy\MazeBuilder.cpp", "C++", 107, 0, 0, 24, 131
"d:\21\Maze3d\src\game\maze_things\legacy\MazeBuilder.hpp", "C++", 38, 0, 1, 12, 51
"d:\21\Maze3d\src\game\maze_things\legacy\MazeMapGenerator.cpp", "C++", 64, 0, 0, 14, 78
"d:\21\Maze3d\src\game\maze_things\legacy\MazeMapGenerator.hpp", "C++", 19, 0, 0, 6, 25
"d:\21\Maze3d\src\game\maze_things\legacy\ObjectMazeBuilder.cpp", "C++", 82, 0, 0, 15, 97
"d:\21\Maze3d\src\game\maze_things\legacy\ObjectMazeBuilder.hpp", "C++", 33, 0, 2, 8, 43
"d:\21\Maze3d\src\game\maze_things\utils\cheatCodeHandler.cpp", "C++", 71, 0, 0, 6, 77
"d:\21\Maze3d\src\game\maze_things\utils\cheatcodeHandler.hpp", "C++", 42, 0, 0, 4, 46
"d:\21\Maze3d\src\game\maze_things\utils\collisionChecker.hpp", "C++", 49, 0, 0, 10, 59
"d:\21\Maze3d\src\game\maze_things\utils\coloredMapGenerator.cpp", "C++", 34, 0, 0, 10, 44
"d:\21\Maze3d\src\game\maze_things\utils\coloredMapGenerator.hpp", "C++", 11, 0, 0, 2, 13
"d:\21\Maze3d\src\game\maze_things\utils\dataHandler.cpp", "C++", 51, 0, 6, 8, 65
"d:\21\Maze3d\src\game\maze_things\utils\dataHandler.hpp", "C++", 22, 0, 0, 3, 25
"d:\21\Maze3d\src\game\maze_things\utils\raycastingHandler.cpp", "C++", 55, 0, 0, 4, 59
"d:\21\Maze3d\src\game\maze_things\utils\raycastingHandler.hpp", "C++", 23, 0, 0, 3, 26
"d:\21\Maze3d\src\game\maze_things\utils\shadowHandler.cpp", "C++", 41, 0, 0, 7, 48
"d:\21\Maze3d\src\game\maze_things\utils\shadowHandler.hpp", "C++", 14, 0, 0, 2, 16
"d:\21\Maze3d\src\game\player\player.cpp", "C++", 33, 0, 0, 10, 43
"d:\21\Maze3d\src\game\player\player.hpp", "C++", 15, 0, 0, 4, 19
"d:\21\Maze3d\src\game\scenes\belarus\belarusScene.cpp", "C++", 52, 0, 2, 12, 66
"d:\21\Maze3d\src\game\scenes\belarus\belarusScene.hpp", "C++", 25, 0, 1, 6, 32
"d:\21\Maze3d\src\game\scenes\loadingScenes\LoadingScene.cpp", "C++", 75, 0, 1, 13, 89
"d:\21\Maze3d\src\game\scenes\loadingScenes\LoadingScene.hpp", "C++", 31, 0, 1, 8, 40
"d:\21\Maze3d\src\game\scenes\maze\maze.cpp", "C++", 161, 0, 0, 22, 183
"d:\21\Maze3d\src\game\scenes\maze\maze.hpp", "C++", 88, 0, 1, 19, 108
"d:\21\Maze3d\src\game\scenes\maze\maze.res.cpp", "C++", 44, 0, 0, 2, 46
"d:\21\Maze3d\src\game\scenes\maze\mazeDraw.cpp", "C++", 80, 0, 2, 18, 100
"d:\21\Maze3d\src\game\scenes\maze\mazeGui.cpp", "C++", 164, 0, 1, 37, 202
"d:\21\Maze3d\src\game\scenes\maze\mazeGui.hpp", "C++", 49, 0, 0, 15, 64
"d:\21\Maze3d\src\game\scenes\maze\mazePhys.cpp", "C++", 63, 0, 1, 13, 77
"d:\21\Maze3d\src\game\scenes\maze\maze_lasers.cpp", "C++", 50, 0, 0, 11, 61
"d:\21\Maze3d\src\game\scenes\menu\endlessWindow.cpp", "C++", 47, 0, 0, 10, 57
"d:\21\Maze3d\src\game\scenes\menu\mainWindow.cpp", "C++", 62, 0, 0, 15, 77
"d:\21\Maze3d\src\game\scenes\menu\menu.cpp", "C++", 74, 0, 1, 16, 91
"d:\21\Maze3d\src\game\scenes\menu\menu.hpp", "C++", 37, 0, 0, 13, 50
"d:\21\Maze3d\src\game\scenes\menu\menuGui.cpp", "C++", 106, 0, 1, 20, 127
"d:\21\Maze3d\src\game\scenes\menu\menuGui.hpp", "C++", 94, 0, 1, 21, 116
"d:\21\Maze3d\src\game\scenes\menu\resourceMenuGui.cpp", "C++", 32, 0, 0, 6, 38
"d:\21\Maze3d\src\game\scenes\menu\timedWindow.cpp", "C++", 104, 0, 2, 22, 128
"d:\21\Maze3d\src\glad.c", "C", 0, 1770, 25, 47, 1842
"Total", "-", 4825, 1770, 70, 1130, 7795